10 10
2223333344
4445556544
3444343222
2222234556
6667777788
8887777899
8878999877
7667777766
6666777888
8898878776